month,"Retail and food services sales, total",Motor vehicle and parts dealers,Automobile and other motor vehicle dealers,"Automotive parts, acc., and tire stores","Furniture, home furn, electronics, and appliance stores",Furniture and home furnishings stores,Electronics and appliance stores,Building mat. and garden equip. and supplies dealers,Building mat. and supplies dealers,Food and beverage stores,Grocery stores,"Beer, wine and liquor stores",Health and personal care stores,Pharmacies and drug stores,Gasoline stations,Clothing and clothing access. stores,Clothing stores,Men's clothing stores,Women's clothing stores,Shoe stores,Jewelry stores,"Sporting goods, hobby, musical instrument, and book stores",General merchandise stores,Department stores,Other general merchandise stores,Warehouse clubs and superstores,All other gen. merchandise stores,Miscellaneous stores retailers,Nonstore retailers,Electronic shopping and mail order houses,Fuel dealers,Food services and drinking places
"Monday, January 1, 2007",363616,75399,69294,6105,18838,9609,9229,27533,24620,44856,40253,3077,19423,16668,34244,18493,13515,782,3392,2278,2543,6489,48034,18064,29970,26298,3672,9629,24243,17558,2731,36435
"Thursday, February 1, 2007",364006,75841,69794,6047,18492,9369,9123,27088,24037,45274,40646,3129,19401,16620,34932,18144,13294,770,3363,2150,2536,6494,47293,17586,29707,26123,3584,9489,25505,17989,3577,36053
"Thursday, March 1, 2007",367158,75472,69224,6248,18432,9406,9026,27506,24171,45271,40572,3170,19540,16723,35999,18643,13689,738,3404,2288,2502,6779,48132,17798,30334,26651,3683,9771,25034,18149,2911,36579
"Sunday, April 1, 2007",366187,76205,70074,6131,18438,9430,9008,26610,23833,44988,40416,3103,19572,16750,36350,18189,13290,747,3369,2216,2521,6640,47679,17480,30199,26550,3649,9586,25303,18143,3192,36627
"Tuesday, May 1, 2007",370934,77186,70918,6268,18421,9331,9090,27144,24057,45454,40740,3214,19650,16792,37996,18545,13564,739,3540,2204,2618,6805,47887,17521,30366,26709,3657,9843,25271,18421,2949,36732
"Friday, June 1, 2007",368154,74794,68600,6194,18287,9264,9023,26638,23748,45627,40870,3257,19880,16868,37310,18388,13416,724,3433,2230,2579,6850,47852,17328,30524,26882,3642,9988,25462,18586,2879,37078
"Sunday, July 1, 2007",369614,74932,68703,6229,18403,9315,9088,26860,23847,45754,41044,3225,19831,16949,36963,18522,13471,720,3112,2266,2621,6936,48412,17559,30853,27198,3655,9759,25970,19087,2899,37272
"Wednesday, August 1, 2007",371358,76549,70288,6261,18574,9300,9274,26625,23568,45643,40954,3184,20014,16975,37223,18491,13484,667,3374,2263,2584,6780,48704,17527,31177,27479,3698,9740,25826,18920,2908,37189
"Saturday, September 1, 2007",372869,77176,70881,6295,18315,9141,9174,26412,23217,45853,41095,3198,20132,17003,38210,18412,13426,705,3323,2219,2603,6749,48288,17260,31028,27353,3675,9783,26112,19012,3126,37427
"Monday, October 1, 2007",375289,77617,71206,6411,18435,9142,9293,26248,23030,46113,41379,3156,19988,16942,39307,18431,13444,718,3343,2208,2614,6834,48540,17292,31248,27508,3740,9620,26397,19323,3119,37759
"Thursday, November 1, 2007",378860,75921,69638,6283,18656,9094,9562,26566,23042,46624,41868,3182,19938,16950,41985,18759,13689,736,3353,2249,2657,6940,49047,17346,31701,27924,3777,9632,27065,19603,3440,37727
"Saturday, December 1, 2007",374298,73345,67126,6219,18377,9009,9368,25634,22691,46831,41998,3235,19825,17069,41593,18570,13576,752,3338,2248,2580,6756,49302,17199,32103,28269,3834,9688,26268,18719,3480,38109
"Tuesday, January 1, 2008",375236,73834,67606,6228,18048,8873,9175,25721,22639,46862,42159,3196,20120,17208,42423,18542,13494,755,3267,2249,2631,6818,48951,16813,32138,28279,3859,10074,26019,18688,3382,37824
"Friday, February 1, 2008",371833,72206,65976,6230,17790,8594,9196,25659,22444,46707,42016,3196,20279,17375,42504,18280,13361,725,3285,2207,2550,6751,48927,16822,32105,28367,3738,9380,26101,18729,3532,37249
"Saturday, March 1, 2008",372745,71774,65537,6237,17802,8631,9171,25456,22258,46883,42168,3217,20288,17321,43044,18338,13271,732,3268,2256,2642,6733,48990,16697,32293,28575,3718,9355,26530,18891,3805,37552
"Tuesday, April 1, 2008",372572,70052,63765,6287,17892,8606,9286,25292,22276,47356,42584,3237,20172,17246,42933,18384,13401,726,3310,2288,2527,6809,49433,16708,32725,28946,3779,9277,27243,19293,4044,37729
"Thursday, May 1, 2008",376036,69143,62769,6374,18117,8587,9530,25650,22413,47355,42549,3263,20536,17521,44344,18642,13564,732,3312,2347,2566,6949,50375,16916,33459,29602,3857,9310,27526,19478,4061,38089
"Sunday, June 1, 2008",376455,67161,60739,6422,17778,8473,9305,25700,22379,47568,42683,3315,20497,17511,46547,18708,13594,729,3280,2336,2614,6879,50762,17059,33703,29841,3862,9308,27403,19472,3970,38144
"Tuesday, July 1, 2008",375038,64397,57934,6463,17698,8369,9329,25897,22431,47845,42899,3350,20640,17571,46813,18635,13491,697,3299,2324,2654,6858,50582,16779,33803,29922,3881,9583,27823,19673,4177,38267
"Friday, August 1, 2008",372284,64985,58687,6298,17355,8154,9201,25329,22041,47988,43063,3335,20620,17695,45645,18524,13426,704,3278,2318,2612,6931,50131,16645,33486,29649,3837,9163,27374,19387,3918,38239
"Monday, September 1, 2008",366729,62549,56200,6349,16536,7722,8814,25217,21861,47740,42834,3320,20654,17634,45777,17560,12841,684,3195,2168,2403,6536,49436,16079,33357,29572,3785,9080,27258,19482,3883,38386
"Wednesday, October 1, 2008",352950,56599,50253,6346,16467,7735,8732,24568,21406,47703,42768,3354,20659,17683,40584,17317,12612,655,3068,2168,2380,6426,49260,16016,33244,29462,3782,8914,26333,19010,3630,38120
"Saturday, November 1, 2008",339350,54984,48542,6442,16377,7640,8737,23196,20072,47363,42496,3343,20789,17756,31776,17173,12703,654,3041,2162,2154,6431,49464,16329,33135,29382,3753,8630,25149,18197,3324,38018
"Monday, December 1, 2008",332091,54123,47728,6395,15811,7460,8351,22909,19812,46942,42136,3304,20682,17721,27999,16868,12549,631,2928,2125,2053,6470,48906,15839,33067,29302,3765,8564,24751,18383,2810,38066
"Thursday, January 1, 2009",336929,55790,49379,6411,16247,7363,8884,22758,19652,47639,42771,3375,20753,17653,28818,17159,12812,642,2960,2118,2088,6661,49288,15861,33427,29613,3814,8511,25049,18702,2890,38256
"Sunday, February 1, 2009",335576,54188,47822,6366,16129,7285,8844,22498,19508,46928,42101,3311,20906,17943,29860,17401,12955,636,2978,2152,2151,6535,49199,15627,33572,29669,3903,8746,25241,18832,2762,37945
"Sunday, March 1, 2009",329747,53100,46853,6247,15140,7041,8099,22149,19145,46912,42069,3327,20908,18015,28825,16510,12211,607,2915,2100,2060,6360,48840,15532,33308,29434,3874,8615,24941,18701,2720,37447
"Wednesday, April 1, 2009",331352,53557,47280,6277,15116,7067,8049,22092,19098,47133,42288,3323,21059,18190,28747,16900,12506,645,3042,2109,2148,6514,48887,15638,33249,29311,3938,8677,24932,18816,2625,37738
"Friday, May 1, 2009",334256,54089,47827,6262,15113,7087,8026,22310,19337,47219,42300,3366,21121,18164,30488,17038,12651,627,3031,2103,2132,6453,49085,15727,33358,29376,3982,8426,25159,19070,2599,37755
"Monday, June 1, 2009",339883,56611,50407,6204,15131,7092,8039,22332,19218,47350,42530,3300,21055,18070,33375,16817,12390,614,2996,2110,2148,6473,48792,15427,33365,29421,3944,8465,25768,19455,2771,37714
"Wednesday, July 1, 2009",340517,57748,51605,6143,15004,7039,7965,21883,18911,47330,42480,3335,21027,18102,33066,17015,12596,639,2988,2131,2136,6455,48812,15493,33319,29372,3947,8352,26110,19839,2659,37715
"Saturday, August 1, 2009",346668,62263,56161,6102,14991,6991,8000,21474,18872,47309,42401,3389,21070,18055,34658,17233,12760,608,3103,2182,2138,6628,48934,15539,33395,29417,3978,8313,26150,19933,2731,37645
"Tuesday, September 1, 2009",338507,53534,47483,6051,14946,6981,7965,21363,18922,47559,42691,3367,21231,18320,34800,17172,12675,616,3049,2162,2186,6484,49220,15493,33727,29627,4100,8385,26339,20151,2713,37474
"Thursday, October 1, 2009",341654,56469,50371,6098,14835,6915,7920,20661,18325,47603,42763,3378,21278,18309,34885,17296,12884,592,3058,2150,2119,6408,49725,15620,34105,29997,4108,8360,26634,20204,2884,37500
"Sunday, November 1, 2009",344375,57355,51339,6016,15199,6991,8208,20931,18313,47689,42808,3363,21288,18315,36573,17105,12639,585,3017,2134,2188,6307,49156,15482,33674,29573,4101,8406,26666,20389,2835,37700
"Tuesday, December 1, 2009",346072,57079,50990,6089,15092,7024,8068,20849,18210,48134,43192,3431,21195,18193,37182,17127,12601,583,2974,2182,2201,6523,49657,15459,34198,30104,4094,8591,26984,20550,3011,37659
"Friday, January 1, 2010",346189,56920,50816,6104,15243,7011,8232,20566,17842,47877,43028,3394,21144,18109,37358,17346,12860,595,3052,2198,2146,6555,49864,15578,34286,30194,4092,8376,27280,20726,3052,37660
"Monday, February 1, 2010",346787,55856,49638,6218,15605,7123,8482,20448,17719,48705,43735,3455,21199,18113,36950,17362,12848,602,3013,2228,2144,6404,50489,15483,35006,30849,4157,8246,27256,20742,3023,38267
"Monday, March 1, 2010",354608,60953,54633,6320,15357,7235,8122,21883,19201,48274,43304,3448,21363,18264,37160,17880,13233,619,3142,2319,2182,6494,50382,15757,34625,30399,4226,8706,27817,21521,2730,38339
"Thursday, April 1, 2010",357270,61823,55332,6491,15410,7121,8289,23518,20065,48205,43186,3481,21492,18358,37182,17728,13202,609,3128,2243,2143,6445,50494,15547,34947,30605,4342,8570,27745,21458,2728,38658
"Saturday, May 1, 2010",354015,61617,55204,6413,15483,7117,8366,21742,19051,48202,43266,3423,21378,18313,36537,17612,13107,602,3100,2245,2118,6460,49927,15366,34561,30360,4201,8623,27775,21459,2885,38659
"Tuesday, June 1, 2010",354127,61478,55026,6452,15564,7072,8492,21544,18795,47914,42963,3435,21683,18595,35809,17532,13046,603,3117,2236,2100,6504,49958,15361,34597,30381,4216,8802,28462,21995,2949,38877
"Thursday, July 1, 2010",354579,62510,56047,6463,15455,7094,8361,21499,18628,47919,43011,3392,21755,18522,35731,17552,12998,595,3098,2239,2164,6495,49928,15227,34701,30464,4237,8607,28095,21793,2850,39033
"Sunday, August 1, 2010",356747,62551,55897,6654,15459,7130,8329,21268,18410,48258,43258,3475,21841,18569,36189,17672,13106,584,3126,2272,2141,6532,50161,15236,34925,30666,4259,8640,28774,22362,2848,39402
"Wednesday, September 1, 2010",359299,63136,56502,6634,15491,7108,8383,21336,18454,48631,43601,3473,21933,18665,37319,17670,13178,590,3175,2261,2071,6462,50276,15193,35083,30783,4300,8776,28884,22426,2915,39385
"Friday, October 1, 2010",363522,64805,58135,6670,15304,7039,8265,22040,18834,48575,43493,3508,22105,18742,38519,17984,13251,619,3198,2307,2256,6533,50270,15151,35119,30802,4317,8932,28976,22561,2964,39479
"Monday, November 1, 2010",367345,65498,58792,6706,15218,7104,8114,21964,18980,49136,44077,3482,22180,18894,39272,18510,13703,633,3222,2339,2291,6671,51344,15698,35646,31274,4372,8891,28951,22567,2995,39710
"Wednesday, December 1, 2010",369249,65244,58466,6778,15347,7062,8285,22099,19210,49157,44184,3424,22312,18994,41279,18212,13530,627,3227,2318,2188,6584,50937,15320,35617,31303,4314,8898,29672,22820,3345,39508
"Saturday, January 1, 2011",371798,66286,59677,6609,15210,6992,8218,21484,18647,49682,44684,3463,22579,19348,41732,18322,13465,618,3190,2361,2313,6544,50862,15248,35614,31258,4356,8822,30617,23715,3417,39658
"Tuesday, February 1, 2011",375056,67320,60656,6664,15492,7145,8347,21193,18317,50070,44961,3523,22451,19131,42294,18532,13704,631,3313,2368,2280,6620,51463,15452,36011,31542,4469,9122,30117,23325,3331,40382
"Tuesday, March 1, 2011",378471,67587,60775,6812,15839,7397,8442,21863,18955,50075,45068,3490,22584,19253,43737,18719,13790,653,3313,2358,2381,6644,51587,15319,36268,31747,4521,8848,30452,23603,3294,40536
"Friday, April 1, 2011",380773,66876,60132,6744,15850,7321,8529,22066,19160,50805,45723,3478,22448,19097,44604,18923,13833,647,3292,2377,2525,6637,52151,15603,36548,31911,4637,9052,30737,23785,3417,40624
"Sunday, May 1, 2011",380282,65855,59027,6828,15661,7245,8416,22324,19263,50427,45365,3474,22585,19350,45300,18864,13800,654,3309,2399,2485,6557,51768,15272,36496,32001,4495,8968,30923,24122,3322,41050
"Wednesday, June 1, 2011",383197,66654,59625,7029,15657,7227,8430,22720,19563,50940,45791,3533,22630,19313,44698,19179,14089,662,3443,2465,2445,6592,52378,15585,36793,32171,4622,9073,31136,24301,3327,41540
"Friday, July 1, 2011",382790,66429,59475,6954,15820,7263,8557,22761,19761,50948,45797,3538,22728,19253,44712,18975,13951,649,3355,2415,2421,6435,52086,15246,36840,32272,4568,9171,31209,24424,3332,41516
"Monday, August 1, 2011",383946,65792,58685,7107,15948,7333,8615,22786,19709,51177,46034,3537,22822,19365,45159,18911,13773,619,3170,2433,2519,6655,52128,15098,37030,32435,4595,9218,31632,24719,3424,41718
"Thursday, September 1, 2011",387709,68823,61682,7141,15877,7384,8493,22637,19565,51047,45840,3589,22718,19348,45127,19508,14290,670,3386,2495,2538,6693,52660,15297,37363,32745,4618,9159,31447,24602,3366,42013
"Saturday, October 1, 2011",389921,69812,62787,7025,16098,7303,8795,23242,19932,51334,46047,3587,22783,19399,44846,19086,14040,665,3320,2480,2382,6535,52422,15128,37294,32657,4637,9065,32494,25519,3419,42204
"Tuesday, November 1, 2011",391589,70293,63236,7057,16023,7385,8638,22904,19651,51435,46185,3606,22782,19374,45622,19370,14318,668,3369,2499,2371,6501,52592,15151,37441,32684,4757,9045,32785,25806,3303,42237
"Thursday, December 1, 2011",391837,71614,64592,7022,15992,7530,8462,23447,20114,51185,46035,3519,22717,19282,45243,19526,14416,687,3450,2531,2401,6327,52509,15132,37377,32633,4744,8875,32538,25976,2992,41864
"Sunday, January 1, 2012",395376,71646,64453,7193,16150,7637,8513,23618,20281,51540,46248,3635,22857,19343,45702,19615,14484,682,3509,2539,2405,6625,53153,15013,38140,33275,4865,9299,32405,25905,2779,42766
"Wednesday, February 1, 2012",400228,72589,65522,7067,16156,7627,8529,23573,20329,51662,46353,3655,23022,19386,47171,20148,14731,660,3538,2668,2563,6748,53822,15214,38608,33779,4829,9433,32909,26420,2733,42995
"Thursday, March 1, 2012",401804,72775,65788,6987,16285,7587,8698,24570,20974,52112,46753,3690,22967,19362,47448,20035,14830,661,3596,2604,2416,6902,53701,15192,38509,33508,5001,9184,32883,26365,2638,42942
"Sunday, April 1, 2012",399915,72871,65867,7004,16069,7510,8559,23390,20004,52299,46927,3701,23021,19360,46913,19519,14475,682,3441,2531,2325,6859,53243,14837,38406,33554,4852,9193,33173,26499,2949,43365
"Tuesday, May 1, 2012",399363,73572,66626,6946,16349,7645,8704,22748,19653,52284,46873,3723,22883,19277,45808,19679,14498,688,3448,2538,2457,6877,53159,14680,38479,33673,4806,8897,33794,26921,3164,43313
"Friday, June 1, 2012",396140,72581,65639,6942,16220,7552,8668,22571,19682,52212,46842,3698,22471,18821,43811,19874,14698,705,3489,2537,2439,6797,53200,14766,38434,33650,4784,9090,33729,27036,3142,43584
"Sunday, July 1, 2012",397458,73004,65960,7044,16400,7650,8750,22697,19604,52276,46956,3638,22770,19015,43484,19741,14577,690,3449,2550,2423,6798,53292,14813,38479,33667,4812,9173,34147,27339,3229,43676
"Wednesday, August 1, 2012",402152,73859,66948,6911,16256,7600,8656,23075,19899,52295,47013,3611,22763,19054,46434,19939,14714,682,3375,2592,2445,6692,53568,14753,38815,33955,4860,9093,34423,27740,3255,43755
"Saturday, September 1, 2012",405366,75275,68220,7055,16233,7614,8619,23696,20213,52506,47131,3680,22608,18926,46966,20093,14731,716,3485,2625,2511,6677,53376,14673,38703,33858,4845,9111,34740,27937,3369,44085
"Monday, October 1, 2012",405925,74807,67769,7038,15766,7416,8350,23820,20423,52860,47449,3708,22482,18956,48212,19935,14696,697,3503,2575,2432,6695,53690,14570,39120,34176,4944,9148,34714,27958,3219,43796
"Thursday, November 1, 2012",407580,75763,68791,6972,16301,7641,8660,24108,20689,52750,47310,3749,22684,18946,46822,20020,14678,684,3479,2631,2480,6681,53496,14438,39058,34126,4932,9083,35305,28580,3225,44567
"Saturday, December 1, 2012",408793,76859,69889,6970,16759,7959,8800,24130,20664,52593,47097,3798,22940,19086,45787,20168,14673,708,3418,2578,2685,6790,53622,14442,39180,34105,5075,9329,35322,28663,2941,44494
"Tuesday, January 1, 2013",412238,77647,70663,6984,16734,7906,8828,24402,20880,52644,47219,3756,23230,19475,45970,20418,15099,770,3664,2587,2518,7029,54048,14744,39304,34275,5029,9224,35754,28997,3021,45138
"Friday, February 1, 2013",417250,78801,71712,7089,16754,7850,8904,24824,21160,53203,47641,3805,23093,19302,48895,20299,14892,690,3397,2606,2572,7024,54471,14530,39941,34870,5071,9288,35737,28828,3146,44861
"Friday, March 1, 2013",414217,77849,70861,6988,16534,7851,8683,24800,21255,53071,47577,3787,23146,19335,47392,20295,14833,707,3444,2660,2575,6907,54149,14418,39731,34656,5075,9384,35648,28809,3167,45042
"Monday, April 1, 2013",412268,78295,71342,6953,16555,7814,8741,24974,21556,52680,47245,3783,23065,19264,45918,20477,14902,709,3452,2767,2582,6812,54096,14208,39888,34747,5141,9341,35344,28574,3147,44711
"Wednesday, May 1, 2013",414137,79464,72404,7060,16470,7733,8737,25461,21841,53197,47728,3817,23201,19323,45257,20356,14948,703,3460,2685,2489,6873,54334,14310,40024,34820,5204,9358,35366,28746,2934,44800
"Saturday, June 1, 2013",415642,81097,74096,7001,16716,7956,8760,24969,21597,53155,47711,3790,23196,19380,45527,20345,14913,686,3453,2696,2505,6909,54269,14181,40088,34895,5193,9206,35573,28914,2881,44680
"Monday, July 1, 2013",418458,81458,74421,7037,16645,7937,8708,25564,21821,53548,48013,3868,23464,19548,45621,20553,15132,731,3518,2734,2454,6947,54474,14074,40400,35139,5261,9237,35915,29210,2924,45032
"Thursday, August 1, 2013",417547,81086,73977,7109,16692,7982,8710,25513,21923,53665,48085,3890,23506,19641,45216,20285,14876,734,3519,2716,2450,6777,54299,14032,40267,35027,5240,9334,36041,29303,2879,45133
"Sunday, September 1, 2013",417421,79715,72641,7074,16695,8041,8654,25519,21924,53744,48190,3883,23914,20080,45245,20273,14804,721,3507,2708,2521,6880,54644,14088,40556,35247,5309,9527,35935,29403,2957,45330
"Tuesday, October 1, 2013",419276,81123,73918,7205,16911,8140,8771,25159,21747,53865,48339,3856,23933,19979,44590,20750,15041,762,3515,2832,2642,6863,54714,14218,40496,35223,5273,9515,35929,29173,3101,45924
"Friday, November 1, 2013",420556,81597,74325,7272,16853,8202,8651,25104,21683,53940,48337,3907,23990,20076,44267,20233,14733,746,3447,2712,2559,6901,54600,14050,40550,35277,5273,9597,36737,29473,3398,46737
"Sunday, December 1, 2013",422886,81058,73755,7303,16521,7913,8608,25269,21694,54524,48875,3912,24022,20122,46125,20531,14933,735,3440,2768,2600,6867,54444,13947,40497,35236,5261,9429,37785,30136,3676,46311
"Wednesday, January 1, 2014",418524,78614,71451,7163,16388,7751,8637,25200,21716,54715,49018,3959,24027,20210,46512,20467,14829,737,3401,2754,2656,6478,54321,13679,40642,35327,5315,9287,36598,29152,3801,45917
"Saturday, February 1, 2014",424674,81181,73938,7243,16725,8048,8677,25123,21662,54681,49046,3917,24158,20297,46926,20503,14832,774,3443,2805,2623,6813,55139,14097,41042,35650,5392,9429,37578,30044,3860,46418
"Saturday, March 1, 2014",429134,83961,76718,7243,16911,8186,8725,25620,21975,54803,49131,3931,24293,20406,46219,20612,15005,752,3445,2777,2614,6811,55209,14058,41151,35803,5348,9510,38128,30813,3684,47057
"Tuesday, April 1, 2014",433648,85336,78109,7227,17003,8297,8706,26544,22596,55143,49419,3976,24553,20600,46508,21112,15412,748,3445,2841,2645,6931,55691,14405,41286,35850,5436,9408,38277,31187,3403,47142
"Thursday, May 1, 2014",434351,85507,78390,7117,16864,8276,8588,26785,23049,55362,49641,3963,24894,20819,46146,20698,15105,736,3456,2772,2602,6906,55672,14177,41495,36032,5463,9574,38407,31406,3151,47536
"Sunday, June 1, 2014",435430,85660,78630,7030,16803,8287,8516,26989,23231,55865,50008,4081,25076,21009,45084,20727,15105,722,3397,2801,2603,6983,55672,13960,41712,36207,5505,9640,39227,32402,3070,47704
"Tuesday, July 1, 2014",436137,86014,78989,7025,16919,8312,8607,26478,22964,56036,50219,4040,25142,21057,45085,20864,15218,729,3458,2798,2640,6954,55771,14059,41712,36195,5517,9669,39140,32255,3100,48065
"Friday, August 1, 2014",439650,86770,79665,7105,17131,8447,8684,27015,23367,56183,50342,4061,25254,21117,45192,20982,15333,736,3497,2782,2655,7180,56125,14081,42044,36487,5557,9803,39669,32692,3083,48346
"Monday, September 1, 2014",438707,85961,78880,7081,17276,8396,8880,26977,23456,56348,50545,4045,25400,21230,44682,20764,15218,731,3458,2751,2577,7075,55757,13852,41905,36358,5547,9772,39766,32927,2989,48929
"Wednesday, October 1, 2014",439889,86269,79176,7093,17233,8407,8826,26920,23246,56626,50741,4102,25289,21065,43731,21059,15444,738,3463,2787,2616,7181,55927,13850,42077,36511,5566,9950,40163,33473,2824,49541
"Saturday, November 1, 2014",441277,87305,79824,7481,17564,8524,9040,27121,23316,56597,50743,4046,25430,21208,42825,21310,15732,758,3511,2804,2560,7132,55992,13903,42089,36533,5556,9885,40518,33648,3041,49598
"Monday, December 1, 2014",438800,86863,79817,7046,17675,8656,9019,26813,23092,56880,50898,4124,25588,21470,39695,21232,15680,741,3557,2791,2537,7056,56047,13958,42089,36465,5624,9875,40697,34254,2738,50379
"Thursday, January 1, 2015",436110,87943,80761,7182,17495,8619,8876,27057,23458,56909,50969,4115,25818,21519,35811,20943,15289,736,3446,2815,2615,6927,56140,13920,42220,36611,5609,9903,40520,34152,2731,50644
"Sunday, February 1, 2015",435340,86646,79371,7275,17161,8424,8737,26077,22579,56977,51039,4135,25617,21322,37026,21207,15533,764,3389,2835,2631,6967,55780,13761,42019,36414,5605,9818,41517,34628,3238,50547
"Sunday, March 1, 2015",441880,90323,82993,7330,17229,8677,8552,27117,23622,56967,50984,4206,26216,22014,37522,21310,15648,738,3422,2839,2614,7063,55986,13889,42097,36390,5707,9834,41381,34750,2854,50932
"Wednesday, April 1, 2015",442600,90840,83414,7426,17438,8788,8650,27349,23693,56864,50845,4167,25806,21573,36922,21351,15662,735,3357,2815,2638,7071,55840,13723,42117,36495,5622,9807,41698,35276,2555,51614
"Friday, May 1, 2015",446206,91620,84152,7468,17669,8965,8704,27399,23649,56944,50952,4197,25804,21591,38339,21544,15802,735,3456,2894,2637,7119,56370,13929,42441,36694,5747,10070,41640,35506,2434,51688
"Monday, June 1, 2015",446898,91602,84054,7548,17635,8796,8839,27164,23506,57155,51121,4209,25984,21684,38939,21290,15543,731,3412,2842,2692,7094,56243,13682,42561,36835,5726,10100,41909,35600,2463,51783
"Wednesday, July 1, 2015",449767,91567,83983,7584,17590,8940,8650,27957,24192,57374,51302,4243,26257,21883,39227,21430,15668,737,3409,2881,2659,7152,56478,13624,42854,37110,5744,10144,42544,36255,2411,52047
"Saturday, August 1, 2015",449975,92169,84679,7490,17638,8977,8661,28045,24297,57410,51327,4256,26440,22017,38115,21496,15774,758,3473,2869,2637,7189,56243,13585,42658,36844,5814,10224,42616,36509,2308,52390
"Tuesday, September 1, 2015",448739,92696,85265,7431,17652,8958,8694,27874,24141,57246,51194,4221,26807,22676,35948,21345,15686,721,3391,2904,2532,7225,56656,13643,43013,37195,5818,9816,43088,36934,2282,52386
"Thursday, October 1, 2015",447496,92247,84797,7450,17648,9036,8612,28040,24255,57017,51034,4210,26578,22203,35494,21116,15475,722,3410,2915,2504,7129,56309,13575,42734,36892,5842,9804,43333,37195,2234,52781
"Sunday, November 1, 2015",449242,93000,85431,7569,17482,9036,8446,28352,24665,57450,51435,4249,26728,22334,34982,21284,15593,722,3412,2903,2561,7254,56497,13569,42928,37062,5866,9923,43305,37465,1945,52985
"Tuesday, December 1, 2015",450978,92569,85075,7494,17691,9227,8464,28884,25276,57265,51154,4315,27009,22591,34792,21390,15515,737,3500,2960,2666,7397,56657,13410,43247,37328,5919,9854,43615,37844,1761,53855
"Friday, January 1, 2016",448325,92292,84661,7631,17412,9093,8319,28977,25179,57526,51481,4229,26819,22403,33455,21211,15527,712,3426,2942,2536,7348,55778,13173,42605,36702,5903,9876,44516,38469,2007,53115
"Monday, February 1, 2016",452555,94522,86938,7584,17566,9134,8432,29020,25289,57553,51314,4347,27357,22824,31890,21864,15910,730,3503,3107,2594,7325,56611,13167,43444,37424,6020,9839,44746,38790,1981,54262
"Tuesday, March 1, 2016",451132,92595,85102,7493,17374,9085,8289,29733,25625,57040,50886,4303,27226,22776,33195,21413,15626,715,3462,2953,2577,7298,56397,13075,43322,37338,5984,10080,44845,39159,1695,53936
"Friday, April 1, 2016",453034,93044,85654,7390,17377,9068,8309,28772,24961,57674,51504,4338,27445,22995,34150,21327,15569,702,3403,2937,2562,7226,56253,12820,43433,37428,6005,10222,45323,39263,1994,54221
"Sunday, May 1, 2016",454683,93202,85755,7447,17450,9116,8334,28350,24676,57962,51706,4392,27368,22885,34953,21489,15640,714,3386,2989,2620,7275,56091,12652,43439,37421,6018,10068,46227,40003,2090,54248
"Wednesday, June 1, 2016",459088,93729,86196,7533,17571,9262,8309,29117,25286,58285,51995,4433,27557,22948,36116,21585,15806,721,3407,3010,2535,7557,56405,12912,43493,37414,6079,10131,46806,40588,2085,54229
"Friday, July 1, 2016",458579,95136,87717,7419,17580,9194,8386,28866,25211,57967,51673,4443,27508,23008,35673,21346,15641,703,3338,2974,2501,7206,56153,12685,43468,37380,6088,10097,46783,40697,2007,54264
"Monday, August 1, 2016",459022,95324,87831,7493,17656,9172,8484,28796,25153,58172,51886,4453,27414,22761,34898,21716,15933,714,3478,3029,2516,7037,56211,12716,43495,37393,6102,10003,47118,41135,1985,54677
"Thursday, September 1, 2016",461893,96191,88760,7431,17546,9376,8170,28963,25253,58480,52109,4535,27413,22804,35767,21792,15996,695,3376,3028,2534,7056,55716,12620,43096,37024,6072,10270,47434,41424,1935,55265
"Saturday, October 1, 2016",463240,96201,88699,7502,17292,9225,8067,29103,25521,58803,52451,4513,26559,22008,36705,21617,15849,689,3317,2998,2528,7081,56130,12476,43654,37511,6143,10425,48075,41962,2021,55249
"Tuesday, November 1, 2016",462994,95663,88272,7391,17073,9186,7887,29337,25833,58843,52452,4558,26806,22164,36432,21516,15660,695,3347,2998,2614,6960,55993,12250,43743,37611,6132,10039,48099,42216,1945,56233
"Thursday, December 1, 2016",468076,98403,90456,7947,17174,9111,8063,29306,25775,58842,52564,4402,26931,22243,38019,21826,15949,701,3331,3024,2619,7084,55859,12206,43653,37520,6133,10196,49113,42925,2176,55323
"Sunday, January 1, 2017",473832,98325,90747,7578,17470,9307,8163,29845,26348,59238,52860,4522,26898,22334,38604,21863,16068,718,3437,3016,2579,7275,57145,12376,44769,38420,6349,10207,49730,43494,2056,57232
"Wednesday, February 1, 2017",473582,97626,90167,7459,17414,9322,8092,30162,26414,59516,53164,4498,27221,22589,38942,21503,15815,706,3407,2931,2538,7069,56370,12203,44167,37925,6242,10396,50005,43780,2057,57358
"Wednesday, March 1, 2017",472693,95626,88068,7558,17664,9373,8291,29957,26116,60006,53647,4519,27367,22779,38545,21674,15878,744,3377,3038,2544,6997,56706,12200,44506,38151,6355,10303,50619,44311,2141,57229
"Saturday, April 1, 2017",475335,96469,88867,7602,17667,9266,8401,30299,26306,60144,53728,4585,27563,22936,38338,21669,15899,690,3458,3025,2532,7058,57032,12203,44829,38391,6438,10382,51389,45131,2147,57325
"Monday, May 1, 2017",473242,96792,89257,7535,17578,9329,8249,30025,26099,60303,53850,4599,27598,23023,36807,21560,15820,715,3370,2953,2550,6988,56302,12098,44204,37879,6325,10152,51774,45321,2232,57363
"Thursday, June 1, 2017",474798,97631,90144,7487,17558,9381,8177,30036,26174,60109,53689,4593,27796,23264,36243,21710,15931,714,3451,2972,2580,6937,57341,12167,45174,38751,6423,10154,52124,45730,2157,57159
"Saturday, July 1, 2017",475045,97700,90135,7565,17440,9347,8093,30230,26249,60188,53790,4589,27859,23128,36081,21541,15758,696,3432,2897,2642,6878,57044,11988,45056,38578,6478,10403,52544,46176,2115,57137
"Tuesday, August 1, 2017",475653,95319,87865,7454,17528,9420,8108,30331,26425,60458,53981,4626,28118,23353,37278,21724,15870,680,3367,2998,2615,6945,57284,11983,45301,38854,6447,10362,52834,46268,2200,57472
"Friday, September 1, 2017",486056,99932,92304,7628,17549,9368,8181,31432,27604,61090,54630,4633,28224,23522,39278,21844,15887,681,3332,3006,2710,7025,58008,12028,45980,39439,6541,10469,53367,46699,2256,57838
"Sunday, October 1, 2017",486635,100732,93233,7499,17861,9614,8247,31043,27234,61331,54773,4713,28359,23632,39270,21770,15873,669,3342,2949,2698,7053,57763,11934,45829,39358,6471,10510,52837,46333,2153,58106
"Wednesday, November 1, 2017",490648,99195,91593,7602,18075,9719,8356,31402,27559,61455,54882,4709,28446,23643,40396,22067,16094,658,3382,2976,2733,7148,57828,11964,45864,39373,6491,10674,55155,48313,2446,58807
"Friday, December 1, 2017",492996,99301,91455,7846,18049,9723,8326,31459,27517,61804,55275,4686,28383,23648,40956,21768,15975,664,3377,2961,2595,7098,58295,11838,46457,39875,6582,10749,56015,48988,2654,59119
"Monday, January 1, 2018",492600,99148,91604,7544,17977,9619,8358,30524,26817,61661,55021,4757,28429,23804,41388,21867,15927,666,3325,2986,2714,6936,58355,12025,46330,39698,6632,11002,55911,48641,3055,59402
"Thursday, February 1, 2018",494815,98296,90749,7547,18169,9686,8483,31333,27473,61747,55077,4758,28207,23437,41878,22426,16392,691,3380,3057,2732,7179,58496,12030,46466,39889,6577,10943,56359,49539,2371,59782
"Thursday, March 1, 2018",494747,98761,91209,7552,18157,9753,8404,30901,27072,61934,55240,4805,28392,23603,41418,21863,15880,682,3313,2975,2757,7254,57948,11431,46517,39960,6557,10835,57047,50066,2392,60237
"Sunday, April 1, 2018",495967,99140,91580,7560,18474,9941,8533,30952,27301,62231,55545,4815,28612,23765,41176,22103,15992,709,3395,3081,2775,7126,58039,12137,45902,39366,6536,10766,57804,50472,2723,59544
"Tuesday, May 1, 2018",502351,99674,92028,7646,18243,9802,8441,31793,27977,62214,55490,4843,29069,24124,42175,22966,16727,694,3504,3209,2781,7139,59866,12304,47562,40809,6753,10910,57487,50357,2567,60815
"Friday, June 1, 2018",501133,99558,91925,7633,18289,9810,8479,32290,28390,62042,55349,4817,28850,23829,42255,22441,16216,695,3390,3163,2807,6862,58742,11849,46893,40273,6620,10834,57488,50620,2516,61482
"Sunday, July 1, 2018",503834,99704,91988,7716,18233,9848,8385,32292,28395,62436,55716,4842,29078,24186,42446,22686,16467,675,3420,3230,2736,6658,59008,11932,47076,40424,6652,10555,58445,51405,2607,62293
"Wednesday, August 1, 2018",502875,98197,90531,7666,18152,9732,8420,32056,27984,62229,55552,4801,29310,24468,42861,22168,16174,681,3438,3042,2704,6600,59211,11834,47377,40657,6720,10763,58694,51770,2550,62634
"Saturday, September 1, 2018",502407,98576,90809,7767,17997,9729,8268,32202,28047,62454,55661,4874,29239,24342,42470,22269,16186,692,3458,3201,2633,6482,59047,11648,47399,40598,6801,10749,59544,52604,2543,61378
"Monday, October 1, 2018",508036,99640,91878,7762,18053,9739,8314,32791,28334,62660,55835,4877,29517,24552,44100,22643,16352,684,3542,3337,2701,6491,59386,11795,47591,40738,6853,10990,59967,52817,2647,61798
"Thursday, November 1, 2018",508471,99780,92052,7728,17957,9706,8251,32004,27930,62629,55821,4906,29923,24801,42187,22758,16488,693,3653,3392,2623,6559,59945,11809,48136,41024,7112,10979,62173,54881,2531,61577
"Saturday, December 1, 2018",497541,101002,93278,7724,17793,9660,8133,32018,27994,62245,55486,4903,28801,23910,39419,22223,16030,663,3366,3343,2596,6449,58988,11412,47576,40706,6870,10866,56149,49004,2367,61588
"Tuesday, January 1, 2019",505036,99055,91458,7597,17682,9535,8147,33530,29156,63462,56660,4898,29699,24594,38831,22068,15903,716,3444,3329,2581,6514,59079,11441,47638,40775,6863,10616,62884,55475,2398,61616
"Friday, February 1, 2019",504686,99357,91542,7815,17683,9651,8032,31585,27595,62025,55248,4906,29887,24776,40646,21970,15738,649,3363,3362,2618,6576,58594,11490,47104,40387,6717,10650,63494,56222,2434,62219
"Friday, March 1, 2019",512602,102693,94681,8012,17892,9787,8105,31654,27678,63158,56334,4945,29907,24775,42097,22338,16054,667,3474,3376,2646,6588,59467,11438,48029,41159,6870,10825,63306,55985,2544,62677
"Monday, April 1, 2019",515088,102079,94094,7985,17895,9853,8042,31750,27996,63326,56502,4925,29820,24732,42929,22245,15993,675,3426,3313,2675,6671,59703,11478,48225,41282,6943,11083,64511,57185,2460,63076
"Wednesday, May 1, 2019",516913,102437,94476,7961,17973,9872,8101,31200,27794,63397,56622,4922,30065,24944,42480,22150,15952,665,3455,3280,2646,6763,59486,11396,48090,41179,6911,11159,66089,58738,2399,63714
"Saturday, June 1, 2019",518397,102405,94461,7944,17965,9895,8070,31280,27593,63845,57005,4976,30017,24786,41538,22255,16030,652,3419,3284,2646,6845,59594,11326,48268,41364,6904,11269,67026,59446,2448,64358
"Monday, July 1, 2019",521831,103129,95204,7925,18132,9895,8237,31660,27739,64571,57692,4995,29836,24704,42161,22407,16091,667,3444,3298,2740,6703,59939,11423,48516,41596,6920,11224,67356,59770,2422,64713
"Thursday, August 1, 2019",524477,105660,97583,8077,17939,9852,8087,32247,28302,64592,57701,5024,29794,24685,41591,22278,15953,657,3376,3272,2762,6688,59733,11311,48422,41520,6902,11459,67887,60229,2398,64609
"Sunday, September 1, 2019",521335,103535,95607,7928,18126,9948,8178,31771,27820,64091,57220,5005,29840,24718,41439,22251,15886,668,3396,3219,2848,6741,59471,11141,48330,41478,6852,11417,67669,60090,2295,64984
"Tuesday, October 1, 2019",524853,104919,96901,8018,18005,9916,8089,32177,28073,64073,57201,4983,30241,25021,42046,22154,16002,666,3376,3164,2702,6764,59716,11139,48577,41717,6860,11576,68307,60750,2291,64875
"Friday, November 1, 2019",525014,106504,98460,8044,17996,9937,8059,32308,28186,64354,57438,5040,29819,24503,42295,22021,15966,662,3365,3133,2617,6526,59610,11101,48509,41635,6874,11652,67675,60069,2490,64254
"Sunday, December 1, 2019",525467,104837,96848,7989,17844,9746,8098,32807,28748,64522,57622,5065,29770,24500,42815,22644,16395,656,3365,3180,2751,6652,59643,11002,48641,41823,6818,11485,67493,60012,2265,64955
"Wednesday, January 1, 2020",529616,105634,97637,7997,18299,10139,8160,33922,29656,64384,57495,5114,30017,24715,42557,22503,16124,663,3426,3203,2850,6698,59963,11032,48931,42061,6870,11984,68101,60985,2096,65554
"Saturday, February 1, 2020",527273,105229,97423,7806,18189,10133,8056,33314,29233,64329,57337,5145,30006,24802,41302,22135,16016,644,3399,3161,(S),6714,59895,11013,48882,41996,6886,11877,68924,61620,2107,65359
"Sunday, March 1, 2020",483949,77997,70902,7095,14538,7897,6641,33544,29509,81607,73714,6021,31552,27700,34483,11362,7647,283,1542,1691,(S),5557,64986,8607,56379,48246,8133,10230,72365,65332,1974,45728
"Wednesday, April 1, 2020",412766,68468,61763,6705,7792,4034,3758,32815,28361,71116,63869,5573,26952,24700,26048,3013,1951,81,470,427,(S),3667,56129,6181,49948,42456,7492,7591,79143,73479,1937,30032
"Friday, May 1, 2020",488218,101537,93286,8251,11827,7143,4684,37004,32384,72658,64667,6051,27785,24824,29184,8440,5463,130,1037,1483,(S),6514,59492,8431,51061,42946,8115,9091,85256,79351,2017,39430
"Monday, June 1, 2020",529962,110723,101986,8737,16416,9930,6486,37406,32641,71502,63454,6054,29786,26076,33564,16857,11218,262,2165,2721,(S),8325,61256,9441,51815,43676,8139,11088,82900,76398,2009,50139
"Wednesday, July 1, 2020",535923,110051,101477,8574,17885,10143,7742,36696,31973,71751,63768,5997,31075,26546,35086,17306,11671,410,2525,2383,(S),7871,61229,9626,51603,43793,7810,11548,83201,75767,2028,52224
"Saturday, August 1, 2020",538979,110809,102128,8681,18131,10355,7776,37588,32825,70780,62660,6128,30907,26190,35388,17554,11973,352,2554,2024,(S),7291,60964,9413,51551,43715,7836,11700,83398,75978,2056,54469